#######o#########
#x#   #       # #
# # # #### # ## #
# # # #    #    #
#   # ######### #
#####    #      #
#     #### ######
## ####   #      #
#      #   ### ##
############    #
#            #  #
#################